-25
26
-13
10
0000000000000000000000000000000000000000000000000000
1111111111111111111111111111111111111111111111111110
1000000000000000000000000000000000000000000000000010
1000000000000000000000000000000000000000000000000010
1000000000000000000000000000000000000001111111000010
1000000000000000000000000000000000000001111111000010
1000000000000000000000000000000000000001111111000010
1000000111000000000000000000000000000001111111000010
1000000111000000000000000000000000000001111111000010
1000000111000000000000000000000000000001111111000010
1000000111000000000000000000000000000001111111000010
1000000111000000000000000000000000000000000000000010
1000000111000000000000000000000000000000000000000010
1000000111000000000000000000000000000000000000000010
1000000111000000000000000000000000000000000000000010
1000000000000000000000000000000000000000000000000010
1000000000000000000000000000000000000000000000000010
1000000000000000000000000000000000000000000000000010
1000000000000000000000000000000000000000000000000010
1000000000000000000000000000000000000000000000000010
1000000000000000000000000000000000000000000000000010
1000000000000000000000000000000000000000000000000010
1000000000000000000000000000000000000000000000000010
1111111111111111111111111111111111111111111111111110
